=]S                                         0
#>                                          0
#>                              (____)   S[==
#>      P          (____)   C             <##
#>   p      p p    p    p [===]   p   p   <##
##===G======G=G====G====G=#####===G===G===###
#############################################