=]                                         0
#>                                         0
#>                             (____)    [==
#>      P          (____)                <##
#>S  p      p p    p    p [==]   p   p   <##
##===G======G=G====G====G=####===G===G===###
############################################