=]                                         0
#>                                         0
#>                             (____)    [==
#>      P          (____)                <##
#>   p      p p    p    p [==]   p   p   <##
##===G======G=G====G====G=####===G===G===###
############################################