                         p                0
                      [==G===]          [=]
                      ;------:          <#>
    p      p p    p    p                <#>
[===G======G=G====G====G================##>
<#########################################>